PAGINA PRINCIPAL	
	
btn_icon_user 	 id ='global-user-trigger'
btn_log_in  	css= '.user [data-regformid='espn']' 
	
CREAR UNA CUENTA	
btn_sign_up  	css=[class='btn btn-secondary ng-isolate-scope']
txt_first_name 	name='firstName'
txt_last_name 	name='lastName'
txt_email	name='email'
txt_new_password	name='newPassword'
btn_sing_up_modal	css='[class='btn btn-primary ng-scope ng-isolate-scope']'
message_verification	css  = '.user .display-user span'
	
INICIAR SESIÓN	
	
txt_user	css =  [class='ng-pristine ng-invalid ng-invalid-required ng-valid-pattern ng-touched']
txt_password	css =  [class='ng-pristine ng-untouched ng-invalid ng-invalid-required']
brn_log_in	css = [class='btn btn-primary btn-submit ng-isolate-scope']
message_verification	css  = '.user .display-user span'
	
	
ELIMINAR CUENTA	
	
btn_espn_profile	css= .user [tref='/members/v3_1/modifyAccount']
link_delete_account	id = 'cancel-account'
btn_yes_delete	css= [class='btn btn-primary ng-isolate-scope']
message_verification	css =   [class=title title-primary ng-isolate-scope']
	
	
CERRAR SESIÓN.	
	
btn_log_out	css = '#global-header .small'
message_verification	css ='.display-user'
